111111111111111111111111111111111111111111111111111111111
100000100000C110000001110000100000100000C1100000011100001
1000001000111100000000C00000100000100000C1100000011100001
100P0010000000X0000001100000100000X00000C1100000011100001
1111001111000000000000000000100000100000C1100000011100001
10010000X1000011100000000000100000100000C11000X0011100001
10C10000110000000000000000CX100000100000C1100000011100001
100100000000000000000000011110000010X000C1100000011100001
1001111111110011111100000111100000100000C1100000011100001
10000000010000X0000100000111100000100000C1100000011100001
100CC0000000X0E00X0100000111100000100000C1100000011100001
100CC00001111111111100011111100000100000C1100000011100001
100000000000000000X000000000100000100000C1100000011100001
1111111111111000111111111111100000100000C11000X0011100001
1111111111111000001111111111100000100000C1100000011100001
100000100000C110000001110000100000100000C1100000011100001
1000001000111100000000C00000100000100000C1100000011100001
10000010000000X0000001100000100000100000C11000X001110X001
1111001111000000000000000000000000100000C1100000011100001
10010000X1000011100000000000100000100000C1100000011100001
10C10000110000000000000000CX100000100000C1100000011100001
1001000000000000000000000111100000100000C1100000000000001
100111111111001111110000011110000010XXX0C1100000011100001
10000000010000X0000100000111100000100000C00000X0011100001
100CC0000000X0000X0100000111100000100000C1100000011100001
100CC0000111111111110001111111111111111111111111111111111
100000000000000000X00000000011111111111111111111111111111
111111111111111111111111111111111111111111111111111111111
