111111111111111111111111111111111111111111
111111111100011111111111100011111110001111
1C00000P0000000CC00000X0000CC0000000C00001
111111111111001111111111001111111111111111
1E0000000X01000000000000001111111111111111
111111000000000011111111111111111111111111
111111001111110011111111111111111111111111
111111001CCCC10011111111111111111111111111
111111000000000011111111111111111111111111
111111111111111111111111111111111111111111
