11111
10101
1CCC1
1P1E1
11111
