1111111111111111111111111111111111111
1000000000111111100000000000111100011
100P000C10111000000CC000111000000C011
1111111100111000001111001110001100X11
11000000001110X1111110000X00001111111
1100C00C00000000000000001111101111111
11111001101111111011101111X1101111111
1111100X10110C01100CX01111111000CC111
11111C1100110001101111100000001111111
1111101100111011101111101111000111111
111000010000000000000000000000XCC1111
1111111111101111100111111101101111111
11111000111000000001111C0000001111111
111110C000001111000111111111111111111
1111100X11111C0000000C111111111111111
1111110111C110000E0000111111XXX111111
11X0000111011000111000111111XXX111111
1111110000000000000000111111XXX111111
1111111111111X0000000X111111XXX111111
1111111111111111101111111111XXX111111
111111111111111110000000XXXXXXX111111
1111111111111111111111111111111111111
