11111111111111111111111
10C0100000CCC0000010C01
1C1C101111101111101C1C1
10C0X0X0100E0010X0X0C01
11101010101110101010111
10001010101X10101010001
1C101X10101110101X101C1
100X1010000C0000101X001
11111010111111101011111
10000010000000001000001
10111110111X11101111101
100CCC001XXCXX100CCC001
10111110111111101111101
10000010000000001000001
11111010111111101011111
100X1010000P0000101X001
1C1010101011101010101C1
10001010101X10101010001
11101010101110101010111
10C0X0X010000010X0X0C01
1C1C101111101111101C1C1
10C0100000CCC0000010C01
11111111111111111111111
