11111111111111111111111111111
1P00001000X00000001000C0100C1
11111010111010111X10111110111
100000101C0010100010000X00001
10111110111110111110111111101
10000X00000000000000000000001
10111111111011111111111011111
101C0000001010000010X010100C1
10111111101010111010101010111
1X0000001010101C0010100010001
11111110101010111110111111101
1E0000001000100000000X0000001
11111111111111111111111111111
