111111111111111111
111100111111000111
111000111110010011
110C1011111PE10011
100110111111110011
1X0000C11111100111
111110111111001111
111110111100000001
111110111111111101
111110000CCCC00001
111111111111111111
