111111111111111111111
1C0001000CEC0001000C1
101101011111110101101
101000000000000000101
101011011XXX110110101
1CCC0001XXCXX1000CCC1
101011011111110110101
10100C0000P0000C00101
101101011111110101101
1C00010000000001000C1
111111111111111111111
