111111111111111111111111111111111111111
10000000000X00010000100XXX0011111111111
100000P0001110011001100XCX0011111111111
10000111000000000000000XXX001XXXXXXXXX1
100000100001111000000000000010000000001
100C00100000001000001111111110001111101
100000000CCC000000000000000000001000001
11111111111110000001111111111000000CC01
11111100000000000001000010000000100XX01
111000000001110000010CC0100XXX001111111
111000CCC000100000010000100000000000001
11100000000010000001110111111XXXXXXXX01
111111110011111100000000000000000000001
111111110011111111111111111111110011111
111100000000001111111CCCC11111110011111
111100000000001111111CCCC11111110011111
11110X00000X0E1111111CCCC00000000011111
111111111111111111111111111111111111111
