111111111111111111111111111111111111111111
1111111111111000000000C1111111111111111111
111111111111101111111101111111111111111111
111111111111101111X11101111111111111111111
1X0X111111C00X1111111101111111C11111111111
11P111111101111100000000000001011111111111
110111111101111101111111111101011111111101
1101111111X0000000000001100001011111111101
110111111111101111111101101111011111111101
11000000C1111011111111011011110111111111C1
11011111011110000C000X00000000000000000101
110111110111111111111111111011110111110101
11011111X111000000C1111111100C0101C0010101
110111110111011111111111111011110111010101
11X111110111011111111111111011110111C00101
11C111110111011111111111111011110000X11101
110000000000000000000000000X11110111111101
11011101011111111X111111111011110111111101
1100C0010111111110111111111C000X00C1111101
11011111011000C000111111111011111101111101
1100X0C11111111111111000000C000E0X00000001
111111111111111111111111111111111111111111
