1111111111111111111111111111111111111111111
100XC0E0P0000000000000000000000000000000001
1000000011100000000000000000000011100000001
1000000000000000000000000000000000000000001
1000000000000000000000000000000000000000001
1000000011100000000000000000000011100000001
1000000000000000000000000000000000000000001
1000000000000000000000000000000000000000001
1000000011100000000000000000000011100000001
1000000000000000000000000000000000000000001
1000000000000000000000000000000000000000001
1000000011100000000000000000000011100000001
1000000000000000000000000000000000000000001
1000000000000000000000000000000000000000001
1000000011100000000000000000000011100000001
1000000000000000000000000000000000000000001
1000000000000000000000000000000000000000001
1000000011100000000000000000000011100000001
1000000000000000000000000000000000000000001
1000000000000000000000000000000000000000001
1000000011100000000000000000000011100000001
1000000000000000000000000000000000000000001
1000000000000000000000000000000000000000001
1111111111111111111111111111111111111111111
